,year,speaker_name,by_male,by_female,by_male_judge,by_female_judge,by_male_lawyer,by_female_lawyer,by_male_n,by_female_n,by_male_judge_n,by_female_judge_n,by_male_lawyer_n,by_female_lawyer_n
0,1998,Ruth Bader Ginsburg,207,37,97,0,110,37,0.516539440204,0.616666666667,1.0,0.0,0.31884057971,0.685185185185
1,1998,John Paul Stevens,277,5,57,0,220,5,0.69465648855,0.0833333333333,0.587628865979,0.0,0.63768115942,0.0925925925926
2,1998,Stephen G. Breyer,274,38,62,10,212,28,0.687022900763,0.633333333333,0.639175257732,0.666666666667,0.614492753623,0.518518518519
3,1998,Antonin Scalia,397,60,52,6,345,54,1.0,1.0,0.536082474227,0.4,1.0,1.0
4,1998,David H. Souter,78,26,21,6,57,20,0.188295165394,0.433333333333,0.216494845361,0.4,0.165217391304,0.37037037037
5,1998,Anthony M. Kennedy,158,26,55,4,103,22,0.391857506361,0.433333333333,0.567010309278,0.266666666667,0.298550724638,0.407407407407
6,1998,William H. Rehnquist,115,5,9,0,106,5,0.282442748092,0.0833333333333,0.0927835051546,0.0,0.307246376812,0.0925925925926
7,1998,Clarence Thomas,4,0,0,0,4,0,0.0,0.0,0.0,0.0,0.0115942028986,0.0
8,1998,"John G. Roberts, Jr.",33,15,33,15,0,0,0.0737913486005,0.25,0.340206185567,1.0,0.0,0.0
9,1999,Stephen G. Breyer,68,6,15,2,53,4,0.645569620253,0.315789473684,0.4375,0.4,0.736111111111,0.235294117647
10,1999,William H. Rehnquist,42,8,12,1,30,7,0.316455696203,0.421052631579,0.25,0.2,0.416666666667,0.411764705882
11,1999,Antonin Scalia,96,19,24,2,72,17,1.0,1.0,1.0,0.4,1.0,1.0
12,1999,Ruth Bader Ginsburg,46,5,12,0,34,5,0.367088607595,0.263157894737,0.25,0.0,0.472222222222,0.294117647059
13,1999,Anthony M. Kennedy,39,7,12,1,27,6,0.278481012658,0.368421052632,0.25,0.2,0.375,0.352941176471
14,1999,John Paul Stevens,38,1,8,0,30,1,0.26582278481,0.0526315789474,0.0,0.0,0.416666666667,0.0588235294118
15,1999,David H. Souter,39,12,17,5,22,7,0.278481012658,0.631578947368,0.5625,1.0,0.305555555556,0.411764705882
16,1999,"John G. Roberts, Jr.",17,0,17,0,0,0,0.0,0.0,0.5625,0.0,0.0,0.0
17,2003,Ruth Bader Ginsburg,45,4,14,0,31,4,0.222222222222,0.230769230769,0.6,0.0,0.150684931507,0.333333333333
18,2003,David H. Souter,31,5,11,1,20,4,0.0493827160494,0.307692307692,0.4,0.5,0.0,0.333333333333
19,2003,Antonin Scalia,108,14,15,2,93,12,1.0,1.0,0.666666666667,1.0,1.0,1.0
20,2003,Stephen G. Breyer,78,4,20,0,58,4,0.62962962963,0.230769230769,1.0,0.0,0.520547945205,0.333333333333
21,2003,John Paul Stevens,36,1,11,1,25,0,0.111111111111,0.0,0.4,0.5,0.0684931506849,0.0
22,2003,William H. Rehnquist,27,5,5,1,22,4,0.0,0.307692307692,0.0,0.5,0.027397260274,0.333333333333
23,2003,Anthony M. Kennedy,32,5,6,2,26,3,0.0617283950617,0.307692307692,0.0666666666667,1.0,0.0821917808219,0.25
24,2004,Anthony M. Kennedy,68,4,17,3,51,1,0.6,0.444444444444,0.425,0.75,0.716666666667,0.2
25,2004,David H. Souter,83,7,30,4,53,3,0.75,0.777777777778,0.75,1.0,0.75,0.6
26,2004,John Paul Stevens,35,4,12,3,23,1,0.27,0.444444444444,0.3,0.75,0.25,0.2
27,2004,Ruth Bader Ginsburg,86,2,33,0,53,2,0.78,0.222222222222,0.825,0.0,0.75,0.4
28,2004,Stephen G. Breyer,96,9,31,4,65,5,0.88,1.0,0.775,1.0,0.95,1.0
29,2004,Antonin Scalia,108,6,40,1,68,5,1.0,0.666666666667,1.0,0.25,1.0,1.0
30,2004,William H. Rehnquist,8,0,0,0,8,0,0.0,0.0,0.0,0.0,0.0,0.0
31,2005,Antonin Scalia,9,0,1,0,8,0,0.5,0.0,0.25,0.0,0.538461538462,0.0
32,2005,Ruth Bader Ginsburg,9,0,4,0,5,0,0.5,0.0,1.0,0.0,0.307692307692,0.0
33,2005,Anthony M. Kennedy,6,2,0,1,6,1,0.3125,1.0,0.0,1.0,0.384615384615,1.0
34,2005,John Paul Stevens,8,0,1,0,7,0,0.4375,0.0,0.25,0.0,0.461538461538,0.0
35,2005,Stephen G. Breyer,17,0,3,0,14,0,1.0,0.0,0.75,0.0,1.0,0.0
36,2005,David H. Souter,3,1,0,0,3,1,0.125,0.5,0.0,0.0,0.153846153846,1.0
37,2005,"Samuel A. Alito, Jr.",1,0,0,0,1,0,0.0,0.0,0.0,0.0,0.0,0.0
38,2005,"John G. Roberts, Jr.",2,1,1,1,1,0,0.0625,0.5,0.25,1.0,0.0,0.0
39,2006,Ruth Bader Ginsburg,43,9,11,0,32,9,0.714285714286,0.615384615385,0.75,0.0,0.666666666667,0.615384615385
40,2006,Stephen G. Breyer,50,11,14,1,36,10,0.880952380952,0.769230769231,1.0,1.0,0.777777777778,0.692307692308
41,2006,Antonin Scalia,55,3,11,1,44,2,1.0,0.153846153846,0.75,1.0,1.0,0.0769230769231
42,2006,Anthony M. Kennedy,21,5,5,1,16,4,0.190476190476,0.307692307692,0.25,1.0,0.222222222222,0.230769230769
43,2006,David H. Souter,17,9,3,0,14,9,0.0952380952381,0.615384615385,0.0833333333333,0.0,0.166666666667,0.615384615385
44,2006,John Paul Stevens,13,4,2,1,11,3,0.0,0.230769230769,0.0,1.0,0.0833333333333,0.153846153846
45,2006,"John G. Roberts, Jr.",30,14,3,0,27,14,0.404761904762,1.0,0.0833333333333,0.0,0.527777777778,1.0
46,2006,"Samuel A. Alito, Jr.",13,1,5,0,8,1,0.0,0.0,0.25,0.0,0.0,0.0
47,2007,Antonin Scalia,49,11,12,1,37,10,1.0,1.0,1.0,0.5,1.0,1.0
48,2007,"Samuel A. Alito, Jr.",10,2,2,0,8,2,0.0487804878049,0.0,0.0909090909091,0.0,0.0333333333333,0.111111111111
49,2007,Anthony M. Kennedy,19,10,5,2,14,8,0.268292682927,0.888888888889,0.363636363636,1.0,0.233333333333,0.777777777778
50,2007,"John G. Roberts, Jr.",23,8,4,2,19,6,0.365853658537,0.666666666667,0.272727272727,1.0,0.4,0.555555555556
51,2007,Ruth Bader Ginsburg,32,9,8,0,24,9,0.585365853659,0.777777777778,0.636363636364,0.0,0.566666666667,0.888888888889
52,2007,David H. Souter,8,5,1,1,7,4,0.0,0.333333333333,0.0,0.5,0.0,0.333333333333
53,2007,John Paul Stevens,9,2,2,1,7,1,0.0243902439024,0.0,0.0909090909091,0.5,0.0,0.0
54,2007,Stephen G. Breyer,21,5,10,0,11,5,0.317073170732,0.333333333333,0.818181818182,0.0,0.133333333333,0.444444444444
55,2008,"Samuel A. Alito, Jr.",14,1,4,1,10,0,0.0,0.0,0.0,0.25,0.0,0.0
56,2008,Anthony M. Kennedy,21,1,5,0,16,1,0.2,0.0,0.0666666666667,0.0,0.230769230769,0.166666666667
57,2008,"John G. Roberts, Jr.",45,5,9,4,36,1,0.885714285714,0.666666666667,0.333333333333,1.0,1.0,0.166666666667
58,2008,John Paul Stevens,19,3,4,2,15,1,0.142857142857,0.333333333333,0.0,0.5,0.192307692308,0.166666666667
59,2008,Ruth Bader Ginsburg,49,3,19,0,30,3,1.0,0.333333333333,1.0,0.0,0.769230769231,0.5
60,2008,David H. Souter,29,5,7,2,22,3,0.428571428571,0.666666666667,0.2,0.5,0.461538461538,0.5
61,2008,Stephen G. Breyer,30,3,8,2,22,1,0.457142857143,0.333333333333,0.266666666667,0.5,0.461538461538,0.166666666667
62,2008,Antonin Scalia,43,7,8,1,35,6,0.828571428571,1.0,0.266666666667,0.25,0.961538461538,1.0
63,2009,Sonia Sotomayor,50,15,9,4,41,11,0.952380952381,1.0,0.428571428571,0.444444444444,0.97619047619,1.0
64,2009,Stephen G. Breyer,31,8,8,1,23,7,0.5,0.416666666667,0.357142857143,0.111111111111,0.547619047619,0.636363636364
65,2009,"Samuel A. Alito, Jr.",22,3,11,2,11,1,0.285714285714,0.0,0.571428571429,0.222222222222,0.261904761905,0.0909090909091
66,2009,"John G. Roberts, Jr.",25,10,7,2,18,8,0.357142857143,0.583333333333,0.285714285714,0.222222222222,0.428571428571,0.727272727273
67,2009,John Paul Stevens,10,5,3,3,7,2,0.0,0.166666666667,0.0,0.333333333333,0.166666666667,0.181818181818
68,2009,Ruth Bader Ginsburg,41,6,16,0,25,6,0.738095238095,0.25,0.928571428571,0.0,0.595238095238,0.545454545455
69,2009,Anthony M. Kennedy,17,5,3,0,14,5,0.166666666667,0.166666666667,0.0,0.0,0.333333333333,0.454545454545
70,2009,Antonin Scalia,52,9,10,3,42,6,1.0,0.5,0.5,0.333333333333,1.0,0.545454545455
71,2009,Elena Kagan,17,9,17,9,0,0,0.166666666667,0.5,1.0,1.0,0.0,0.0
72,2010,Ruth Bader Ginsburg,20,4,6,1,14,3,0.416666666667,0.166666666667,0.3,0.0,0.461538461538,0.6
73,2010,Stephen G. Breyer,20,2,3,2,17,0,0.416666666667,0.0,0.0,0.125,0.576923076923,0.0
74,2010,Antonin Scalia,31,7,5,4,26,3,0.722222222222,0.416666666667,0.2,0.375,0.923076923077,0.6
75,2010,"John G. Roberts, Jr.",19,14,9,9,10,5,0.388888888889,1.0,0.6,1.0,0.307692307692,1.0
76,2010,Sonia Sotomayor,41,11,13,9,28,2,1.0,0.75,1.0,1.0,1.0,0.4
77,2010,"Samuel A. Alito, Jr.",5,5,3,2,2,3,0.0,0.25,0.0,0.125,0.0,0.6
78,2010,Anthony M. Kennedy,11,2,3,1,8,1,0.166666666667,0.0,0.0,0.0,0.230769230769,0.2
79,2010,Elena Kagan,13,2,9,1,4,1,0.222222222222,0.0,0.6,0.0,0.0769230769231,0.2
80,2011,Elena Kagan,36,11,27,10,9,1,0.488888888889,0.777777777778,1.0,1.0,0.0,0.2
81,2011,"Samuel A. Alito, Jr.",14,5,3,3,11,2,0.0,0.111111111111,0.111111111111,0.0,0.0666666666667,0.4
82,2011,Ruth Bader Ginsburg,22,8,11,4,11,4,0.177777777778,0.444444444444,0.407407407407,0.142857142857,0.0666666666667,0.8
83,2011,Anthony M. Kennedy,14,4,0,4,14,0,0.0,0.0,0.0,0.142857142857,0.166666666667,0.0
84,2011,"John G. Roberts, Jr.",27,10,6,8,21,2,0.288888888889,0.666666666667,0.222222222222,0.714285714286,0.4,0.4
85,2011,Sonia Sotomayor,59,8,20,6,39,2,1.0,0.444444444444,0.740740740741,0.428571428571,1.0,0.4
86,2011,Antonin Scalia,33,13,5,8,28,5,0.422222222222,1.0,0.185185185185,0.714285714286,0.633333333333,1.0
87,2011,Stephen G. Breyer,35,8,10,7,25,1,0.466666666667,0.444444444444,0.37037037037,0.571428571429,0.533333333333,0.2
88,2012,Anthony M. Kennedy,4,0,1,0,3,0,0.272727272727,0.0,0.5,0.0,0.222222222222,0.0
89,2012,Elena Kagan,4,0,2,0,2,0,0.272727272727,0.0,1.0,0.0,0.111111111111,0.0
90,2012,Sonia Sotomayor,12,2,2,2,10,0,1.0,1.0,1.0,1.0,1.0,0.0
91,2012,Stephen G. Breyer,3,1,1,1,2,0,0.181818181818,0.5,0.5,0.5,0.111111111111,0.0
92,2012,"Samuel A. Alito, Jr.",1,0,0,0,1,0,0.0,0.0,0.0,0.0,0.0,0.0
93,2012,Ruth Bader Ginsburg,2,0,0,0,2,0,0.0909090909091,0.0,0.0,0.0,0.111111111111,0.0
94,2012,Antonin Scalia,1,0,0,0,1,0,0.0,0.0,0.0,0.0,0.0,0.0
95,2012,"John G. Roberts, Jr.",2,0,0,0,2,0,0.0909090909091,0.0,0.0,0.0,0.111111111111,0.0
